####################
#  P a    OOO      #
#                  #
#          aa      #
#                  #
####################
