############
#  P a    O#
#  a       #
#  O       #
############
